40

0  0  0  0  0  0  0  0  0  0  0  0  0  0  0  0  0
0  0  0  0  0  0  0  0  0  0  0  0  0  0  0  0  0
1  1  1  1  0  0  0  0  0  0  0  0  0  0  0  0  0
0  0  0  1  0  0  0  0  0  0  0  0  0  0  0  0  0
0  0  0  1  0  0  0  0  0  0  0  0  0  0  0  0  0
0  0  0  1  1  1  1  1  1  1  1  1  0  0  0  0  0
0  0  0  0  0  0  0  0  0  0  0  1  0  0  0  0  0
0  0  0  0  0  0  0  0  0  0  0  1  0  0  0  0  0
0  0  0  0  0  0  0  0  0  0  0  1  1  1  1  1  1
0  0  0  0  0  0  0  0  0  0  0  0  0  0  0  0  0
0  0  0  0  0  0  0  0  0  0  0  0  0  0  0  0  0



 4  4  4  4  4  5  5  5  5  5  5  6  6  6  6  6  6
-1 -1 -1 -1 -1 18 14 20 12 16 28 22 -1 11 11 11 11
-1 -1 -1 -1 -1 29 29 29 29 29 29 29 -1 -1 -1 -1 -1
13 -1 -1 -1 -1 -1 -1 16 28 17 -1 -1 -1 -1 26 20 -1
13 -1 -1 -1 -1 -1 -1 -1 -1 -1 -1 -1 -1 -1 -1 -1 -1
-1 19 26 -1 -1 -1 -1 -1 -1 -1 -1 -1 -1 -1  4  4 -1
-1 -1 -1 -1 -1 -1 -1 -1 -1 -1 -1 -1 -1 13 -1 -1 -1
11 11 11 11 -1 -1 -1 22 13 -1 -1 -1 -1 -1 -1 -1 -1
11 11 11 11 -1 -1  4  4 -1 -1  7 -1 -1 -1 -1 -1  0
12 12 12 12 29 29 29 -1 -1 -1 -1 -1 -1 -1 -1 -1 -1
-1 -1 -1 -1 20 11 19  6 -1 -1 -1 -1 -1 13 16 21 -1
